11111
1001
1P001
100C1
1E001
11111