11111111111111111111111111111111111111111111111
10000111111111100000000110000111111111111111E01
10000000000010000000000110000000100000000000001
1000000001001000110001C111111110000000000000001
100C0000010010001100011100000011100000100101001
100000000100000000000111000000000000C011C010001
10000011111011100000011101000011100000010010001
1000000C00001111000001C101000001110000000010001
10001111111110000000000001000000000010000010001
100011111111100000000011C10000010011100C0000001
100011111111100000000011110010110001000000000C1
100000000000000000000011C0000001000000000000111
1P0C0001111111110000C1100000000000C000100000001
11111111111111111111111111111111111111111111111
